***************************************************************************
*             **    ***        *              *****       *             ***
* *** ** * **    ** *** ** *** * *** ******** **    ** ** * ****** ** *   *
*  ** ** * *** **   *   **   * * *** *     ** ** ****  *  *     ** **  ** *
**  *      *    * *   * ** *         * * *     *       * ** ***    *** *  *
*** ** *** * ** * ****     * * *** *** * ** ** * * *****    *** ** *   * **
*** ** ***        *    *** * *     *** *    ** * *   *   ****** ** * *   **
*          * ** *** ** ***   ***** *     ***** * *** * *      *  *     *  *
* ********** ** *** **    **     * * ***  *       **   * * ** ** ** ***** *
*               *** ** **   * **       ** * *** *    **     *     *   **  *
* *** * **** **           * * ****** * **   *** ** *    ***   *** * * ** **
* *** *    * *  * ********* * *    * * *  * *** ** **** *** ***     *     *
*     ** * * * **  *            ** * * * **        *      * *** ***** *** *
* ** *** * * * *** * * ** ***** **   *   ** **** * * **** * **            *
*  * *** *           * **       *** *** ***    * * * *         *** * **** *
** * **    ** *** **      * * * *** *       ** * * *   * ********* * **   *
** * ** ***   ***    * **** * * *** * ** *****       * *     **      ** * *
*  * **     *   * ****      * * **             * *** * ** ** ** ******  * *
* **    ***   * *      **** * *    ** *** * ****   *   *  ** **        ** *
* *** *   ***** *** ** **** * *** ***  ** *    *** ***** ***  * **** * ** *
*     ***           **            ****    ****           ****             *
***************************************************************************
